                                            -------                       
                                           |.......|                      
                                           |.......##################     
        ---------                          |...../.|                #     
       |..=......|                          --#----                 #     
       |.........######                       #           -----   ###     
       |.........|    #                       #          |.....####       
        --#------     #    -------------      #          |.....|          
          #           #####....?........|  ####           --#--           
          #               |.............####                #             
          #      -----     --------#----                    #             
        ###     |..!..|            #                        #             
       ##       |.....|            ###                    --#------------ 
       #         --#--               #                   |...............|
     --#----       #         --------#--------           |...............|
    |.......########        |.................|          |..*............|
    |...(...|               |.................|           ------------#-- 
    |.......|               |.................|                       #   
     --#----                |.................|                       #   
       #                    |.................#########################   
       #           ##########.................|             #             
       #         ###        |.................|             #             
 ------#--       #           -----------------              #   --------- 
|..*......|      #                                          #  |.........|
|.........|    --#----------                                ####.........|
 --#------    |.............|                ---------         |.........|
   #          |.............|               |.........######   |....+....|
   #####      |.............########        |.........|    #   |.........|
       ########.............|      #         ----#----     #####.........|
               -------------       #####         #             |.........|
                                       #         #              --#------ 
                                   ----#---------#--              #       
                                  |.................|    ##########       
                                  |.................|   ##                
                                  |..........=......#####                 
                                   -----------------                      